elevdump version 2
0 0 0 0 4 1 1 0 0
0 0 0 8 4 1 1 0 0
0 0 0 16 4 1 1 0 0
0 0 0 24 4 1 1 0 0
0 0 0 32 4 1 1 0 0
0 0 0 40 4 1 1 0 0
0 0 0 48 4 1 1 0 0
0 0 0 56 4 1 1 0 0
0 0 0 64 4 1 1 0 0
0 0 0 72 4 1 1 0 0
0 0 0 80 4 1 1 0 0
0 0 0 88 4 1 1 0 0
0 0 0 96 4 1 1 0 0
0 0 0 104 4 1 1 0 0
0 0 0 112 4 1 1 0 0
0 0 0 120 4 1 1 0 0
0 0 8 0 4 1 1 0 0
0 0 8 8 4 1 1 0 0
0 0 8 16 4 1 1 0 0
0 0 8 24 4 1 1 0 0
0 0 8 32 4 1 1 0 0
0 0 8 40 4 1 1 0 0
0 0 8 48 4 1 1 0 0
0 0 8 56 4 1 1 0 0
0 0 8 64 4 1 1 0 0
0 0 8 72 4 1 1 0 0
0 0 8 80 4 1 1 0 0
0 0 8 88 4 1 1 0 0
0 0 8 96 4 1 1 0 0
0 0 8 104 4 1 1 0 0
0 0 8 112 4 1 1 0 0
0 0 8 120 4 1 1 0 0
0 0 16 0 4 1 1 0 0
0 0 16 8 4 1 1 0 0
0 0 16 16 4 1 1 0 0
0 0 16 24 4 1 1 0 0
0 0 16 32 4 1 1 0 0
0 0 16 40 4 1 1 0 0
0 0 16 48 4 1 1 0 0
0 0 16 56 4 1 1 0 0
0 0 16 64 4 1 1 0 0
0 0 16 72 4 1 1 0 0
0 0 16 80 4 1 1 0 0
0 0 16 88 4 1 1 0 0
0 0 16 96 4 1 1 0 0
0 0 16 104 4 1 1 0 0
0 0 16 112 4 1 1 0 0
0 0 16 120 4 1 1 0 0
0 0 24 0 4 1 1 0 0
0 0 24 8 4 1 1 0 0
0 0 24 16 4 1 1 0 0
0 0 24 24 4 1 1 0 0
0 0 24 32 4 1 1 0 0
0 0 24 40 4 1 1 0 0
0 0 24 48 4 1 1 0 0
0 0 24 56 4 1 1 0 0
0 0 24 64 4 1 1 0 0
0 0 24 72 4 1 1 0 0
0 0 24 80 4 1 1 0 0
0 0 24 88 4 1 1 0 0
0 0 24 96 4 1 1 0 0
0 0 24 104 4 1 1 0 0
0 0 24 112 4 1 1 0 0
0 0 24 120 4 1 1 0 0
0 0 32 0 4 1 1 0 0
0 0 32 8 4 1 1 0 0
0 0 32 16 4 1 1 0 0
0 0 32 24 4 1 1 0 0
0 0 32 32 4 1 1 0 0
0 0 32 40 4 1 1 0 0
0 0 32 48 4 1 1 0 0
0 0 32 56 4 1 1 0 0
0 0 32 64 4 1 1 0 0
0 0 32 72 4 1 1 0 0
0 0 32 80 4 1 1 0 0
0 0 32 88 4 1 1 0 0
0 0 32 96 4 1 1 0 0
0 0 32 104 4 1 1 0 0
0 0 32 112 4 1 1 0 0
0 0 32 120 4 1 1 0 0
0 0 40 0 4 1 1 0 0
0 0 40 8 4 1 1 0 0
0 0 40 16 4 1 1 0 0
0 0 40 24 4 1 1 0 0
0 0 40 32 4 1 1 0 0
0 0 40 40 4 1 1 0 0
0 0 40 48 4 1 1 0 0
0 0 40 56 4 1 1 0 0
0 0 40 64 4 1 1 0 0
0 0 40 72 4 1 1 0 0
0 0 40 80 4 1 1 0 0
0 0 40 88 4 1 1 0 0
0 0 40 96 4 1 1 0 0
0 0 40 104 4 1 1 0 0
0 0 40 112 4 1 1 0 0
0 0 40 120 4 1 1 0 0
0 0 48 0 4 1 1 0 0
0 0 48 8 4 1 1 0 0
0 0 48 16 4 1 1 0 0
0 0 48 24 4 1 1 0 0
0 0 48 32 4 1 1 0 0
0 0 48 40 4 1 1 0 0
0 0 48 48 4 1 1 0 0
0 0 48 56 4 1 1 0 0
0 0 48 64 4 1 1 0 0
0 0 48 72 4 1 1 0 0
0 0 48 80 4 1 1 0 0
0 0 48 88 4 1 1 0 0
0 0 48 96 4 1 1 0 0
0 0 48 104 4 1 1 0 0
0 0 48 112 4 1 1 0 0
0 0 48 120 4 1 1 0 0
0 0 56 0 4 1 1 0 0
0 0 56 8 4 1 1 0 0
0 0 56 16 4 1 1 0 0
0 0 56 24 4 1 1 0 0
0 0 56 32 4 1 1 0 0
0 0 56 40 4 1 1 0 0
0 0 56 48 4 1 1 0 0
0 0 56 56 4 1 1 0 0
0 0 56 64 4 1 64 0 0 0 0 0 0 0 0 0 0 0 0 0 0 0 0 50 0 0 0 0 0 0 0 0 0 0 0 0 0 0 0 0 0 0 0 0 0 0 0 0 0 0 0 0 0 0 0 0 0 0 0 0 0 0 0 0 0 0 0 0 0 0 0 0
0 0 56 72 4 1 1 0 0
0 0 56 80 4 1 1 0 0
0 0 56 88 4 1 1 0 0
0 0 56 96 4 1 1 0 0
0 0 56 104 4 1 1 0 0
0 0 56 112 4 1 1 0 0
0 0 56 120 4 1 1 0 0
0 0 64 0 4 1 1 0 0
0 0 64 8 4 1 1 0 0
0 0 64 16 4 1 1 0 0
0 0 64 24 4 1 1 0 0
0 0 64 32 4 1 1 0 0
0 0 64 40 4 1 1 0 0
0 0 64 48 4 1 1 0 0
0 0 64 56 4 1 1 0 0
0 0 64 64 4 1 1 0 0
0 0 64 72 4 1 1 0 0
0 0 64 80 4 1 1 0 0
0 0 64 88 4 1 1 0 0
0 0 64 96 4 1 1 0 0
0 0 64 104 4 1 1 0 0
0 0 64 112 4 1 1 0 0
0 0 64 120 4 1 1 0 0
0 0 72 0 4 1 1 0 0
0 0 72 8 4 1 1 0 0
0 0 72 16 4 1 1 0 0
0 0 72 24 4 1 1 0 0
0 0 72 32 4 1 1 0 0
0 0 72 40 4 1 1 0 0
0 0 72 48 4 1 1 0 0
0 0 72 56 4 1 1 0 0
0 0 72 64 4 1 1 0 0
0 0 72 72 4 1 1 0 0
0 0 72 80 4 1 1 0 0
0 0 72 88 4 1 1 0 0
0 0 72 96 4 1 1 0 0
0 0 72 104 4 1 1 0 0
0 0 72 112 4 1 1 0 0
0 0 72 120 4 1 1 0 0
0 0 80 0 4 1 1 0 0
0 0 80 8 4 1 1 0 0
0 0 80 16 4 1 1 0 0
0 0 80 24 4 1 1 0 0
0 0 80 32 4 1 1 0 0
0 0 80 40 4 1 1 0 0
0 0 80 48 4 1 1 0 0
0 0 80 56 4 1 1 0 0
0 0 80 64 4 1 1 0 0
0 0 80 72 4 1 1 0 0
0 0 80 80 4 1 1 0 0
0 0 80 88 4 1 1 0 0
0 0 80 96 4 1 1 0 0
0 0 80 104 4 1 1 0 0
0 0 80 112 4 1 1 0 0
0 0 80 120 4 1 1 0 0
0 0 88 0 4 1 1 0 0
0 0 88 8 4 1 1 0 0
0 0 88 16 4 1 1 0 0
0 0 88 24 4 1 1 0 0
0 0 88 32 4 1 1 0 0
0 0 88 40 4 1 1 0 0
0 0 88 48 4 1 1 0 0
0 0 88 56 4 1 1 0 0
0 0 88 64 4 1 1 0 0
0 0 88 72 4 1 1 0 0
0 0 88 80 4 1 1 0 0
0 0 88 88 4 1 1 0 0
0 0 88 96 4 1 1 0 0
0 0 88 104 4 1 1 0 0
0 0 88 112 4 1 1 0 0
0 0 88 120 4 1 1 0 0
0 0 96 0 4 1 1 0 0
0 0 96 8 4 1 1 0 0
0 0 96 16 4 1 1 0 0
0 0 96 24 4 1 1 0 0
0 0 96 32 4 1 1 0 0
0 0 96 40 4 1 1 0 0
0 0 96 48 4 1 1 0 0
0 0 96 56 4 1 1 0 0
0 0 96 64 4 1 1 0 0
0 0 96 72 4 1 1 0 0
0 0 96 80 4 1 1 0 0
0 0 96 88 4 1 1 0 0
0 0 96 96 4 1 1 0 0
0 0 96 104 4 1 1 0 0
0 0 96 112 4 1 1 0 0
0 0 96 120 4 1 1 0 0
0 0 104 0 4 1 1 0 0
0 0 104 8 4 1 1 0 0
0 0 104 16 4 1 1 0 0
0 0 104 24 4 1 1 0 0
0 0 104 32 4 1 1 0 0
0 0 104 40 4 1 1 0 0
0 0 104 48 4 1 1 0 0
0 0 104 56 4 1 1 0 0
0 0 104 64 4 1 1 0 0
0 0 104 72 4 1 1 0 0
0 0 104 80 4 1 1 0 0
0 0 104 88 4 1 1 0 0
0 0 104 96 4 1 1 0 0
0 0 104 104 4 1 1 0 0
0 0 104 112 4 1 1 0 0
0 0 104 120 4 1 1 0 0
0 0 112 0 4 1 1 0 0
0 0 112 8 4 1 1 0 0
0 0 112 16 4 1 1 0 0
0 0 112 24 4 1 1 0 0
0 0 112 32 4 1 1 0 0
0 0 112 40 4 1 1 0 0
0 0 112 48 4 1 1 0 0
0 0 112 56 4 1 1 0 0
0 0 112 64 4 1 1 0 0
0 0 112 72 4 1 1 0 0
0 0 112 80 4 1 1 0 0
0 0 112 88 4 1 1 0 0
0 0 112 96 4 1 1 0 0
0 0 112 104 4 1 1 0 0
0 0 112 112 4 1 1 0 0
0 0 112 120 4 1 1 0 0
0 0 120 0 4 1 1 0 0
0 0 120 8 4 1 1 0 0
0 0 120 16 4 1 1 0 0
0 0 120 24 4 1 1 0 0
0 0 120 32 4 1 1 0 0
0 0 120 40 4 1 1 0 0
0 0 120 48 4 1 1 0 0
0 0 120 56 4 1 1 0 0
0 0 120 64 4 1 1 0 0
0 0 120 72 4 1 1 0 0
0 0 120 80 4 1 1 0 0
0 0 120 88 4 1 1 0 0
0 0 120 96 4 1 1 0 0
0 0 120 104 4 1 1 0 0
0 0 120 112 4 1 1 0 0
0 0 120 120 4 1 1 0 0
